R 1980 1080 
NO ./textures/kita.xpm 
SO ./textures/minami.xpm
WE ./textures/nishi.xpm
EA ./textures/east.xpm

S ./textures/barrel.xpm
F 220,100,0
C 225,30,0

11111111111111111111
12222222222222222221
12222222222222222221
12222222222222222221
10000000000000000001
100000000N0000000001
10000000000000000001
11111111111111111111
